# 80x80; 165
11111111111111111111111111111111111111111111111111111111111111111111111111111111
12222110000000000000010000000000000000000000000000000001000000000000000000000001
12222550060000000000010000000000000000000000000000000001000000000000000000000001
12222110000000000000010000000500000000000000000000000001000000000000000000000001
12222110000000000000010000000500000000000000000000000001000000000000000000000001
10000000000100000000010000000500000050000000000000000001000000000000000000000001
10000000000100000000110000000500600050000000500055000001100000000000000000000001
10000000000100000000100000000500000050000000550605000000100000000000000000000001
10000000000100000001100000000550000050000000550005000000100000000000000000000001
11115551111100000001000000000050000050000000500005000000110000000000000000000001
10000000000000000011000000000050000050000000500005006000010000000000000000000001
10000000000000000110000000000050000050006000500005000000010000000000000000000001
10600000000000001100000000000050000050000000500005000000010000000000000000000001
10000000000000011000000000000050000055000000500005500000010000000000000000000001
10000000000000110000000000000050000005000000500600500000010000000000000000000001
10000000000111100000000000000050000005000000500000500060010000000000000000000001
10000000000100000000000000000050006005000000500000500000010000000000000000000001
10000000000000000000000000000050000005000000500000500000010000000000000000000001
10000000000000000000000000000050000005000000500000500000010000000000000000000001
10000000000000000000000000000050000005006000500000500000010000000000000000000001
10000000000000000000000000000050000005000000500600500000010000000000000000000001
10000000000000000000000000000050000005500005500000500600010000000000000000000001
11111111111111111111111100000050000000500005000000500000010000000000000000000001
10000011000000000000000100000050000005500005500000500000010000000000000000000001
10000000000000000000000100000050006005500005500000500000010000000000000000000001
10000000000000000000000100000055000005500005500000500000010000000000000000000001
10000000000000000000000100000055000005000600506000500000010000000000000000000001
10000000000000000000000100000055000005500000500000500600010000000000000000000001
10000000000000000000000100000005000000500000500000500000010000000000000000000001
10000000000000000000000110000000000000000000000000000000010000000000000000000001
10000000000000000000000010000000000000000000000000000000011000000000000000000001
10000000000000000000000100000000000000000000000000000000044000000000000000000001
10000000000000000000000111111110111111111111111111111111111000000000000000000001
10000000000000000000000000000011100000000000000000000000000000000000000000000001
10000000000000000000000000000000000000000000000000000000000000000000000000000001
10000000000000000000000000000000000000000000000000000000000000000000000000000001
10000000000000000000000000000000000000000000000000000000000000000000000000000001
10000000000000000000000000000000000000000000000000000000000000000000000000000001
10000000000000000000000000000000000000000000000000000000000000000000000000000001
10000000000000000000000000000000000000000000000000000000000000000000000000000001
10000000000000000000000000000000000000000000000000000000000000000000000000000001
10000000000000000000000000000000000000000000000000000000000000000000000000000001
10000000000000000000000000000000000000000000000000000000000000000000000000000001
10000000000000000000000000000000000000000000000000000000000000000000000000000001
10000000000000000000000000000000000000000000000000000000000000000000000000000001
10000000000003000000000000000000000000000000000000000000000000000000000000000001
10000000000000000000000000000000000000000000000000000000000000000000000000000001
10000000000000000000000000000000000000000000000000000000000000000000000000000001
10000000000000000000000000000000000000000000000000000000000000000000000000000001
10000000000000000000000000000000000000000000000000000000000000000000000000000001
10000000000000000000000000000000000000000000000000000000000000000000000000000001
10000000000000000000000000000000000000000000000000000000000000000000000000000001
10000000000000000000000000000000000000000000000000000000000000000000000000000001
10000000000000000000000000000000000000000000000000000000000000000000000000000001
10000000000000000000000000000000000000000000000000000000000000000000000000000001
10000000000000000000000000000000000000000000000000000000000000000000000000000001
10000000000000000000000000000000000000000000000000000000000000000000000000000001
10000000000000000000000000000000000000000000000000000000000000000000000000000001
10000000000000000000000000000000000000000000000000000000000000000000000000000001
10000000000000000000000000000000000000000000000000000000000000000000000000000001
10000000000000000000000000000000000000000000000000000000000000000000000000000001
10000000000000000000000000000000000000000000000000000000000000000000000000000001
10000000000000000000000000000000000000000000000000000000000000000000000000000001
10000000000000000000000000000000000000000000000000000000000000000000000000000001
10000000000000000000000000000000000000000000000000000000000000000000000000000001
10000000000000000000000000000000000000000000000000000000000000000000000000000001
10000000000000000000000000000000000000000000000000000000000000000000000000000001
10000000000000000000000000000000000000000000000000000000000000000000000000000001
10000000000000000000000000000000000000000000000000000000000000000000000000000001
10000000000000000000000000000000000000000000000000000000000000000000000000000001
10000000000000000000000000000000000000000000000000000000000000000000000000000001
10000000000000000000000000000000000000000000000000000000000000000000000000000001
10000000000000000000000000000000000000000000000000000000000000000000000000000001
10000000000000000000000000000000000000000000000000000000000000000000000000000001
10000000000000000000000000000000000000000000000000000000000000000000000000000001
10000000000000000000000000000000000000000000000000000000000000000000000000000001
10000000000000000000000000000000000000000000000000000000000000000000000000000001
10000000000000000000000000000000000000000000000000000000000000000000000000000001
10000000000000000000000000000000000000000000000000000000000000000000000000000001
11111111111111111111111111111111111111111111111111111111111111111111111111111111