# 80x80
00000000000000000000000000000000000000000000000000000000000000000000000000000000
00000000000000000000000000000000000000000000000000000000000000000000000000000000
00011111111111111111111111111111111111111111111111111111111111111111111111111000
00011111111111111111111111111111111111111111111111111111111111111111111111111000
00011111111111111111111111111111111111111111111111111111111111111111111111111000
00011111111111111111111111111111111111111111111111111111111111111111111111111000
00011111111111111111111111111111111111111111111111111111111111111111111111111000
00011111222000000000000100000000001000000000000000000000000000000000000011111000
00011111222000000000060100000000001000000000000000000000000000000000000011111000
00011111222000000000000100000000001000000000000000000000000000000000000011111000
00011111000100050001000100003300001000000000000000000000000000000000000011111000
00011111000500050005000100003300001000000000000000000000000000000000000011111000
00011111000500050005000100000000001000000000000000000000000000000000000011111000
00011111000500050005000100000000001000000000000000000000000000000000000011111000
00011111000500050005000100000000001000000000000000000000000000000000000011111000
00011111000100050001000100000000001000000000000000000000000000000000000011111000
00011111000000000000000100060000001000000000000000000000000000000000000011111000
00011111000000000000000100000000001000000000000000000000000000000000000011111000
00011111000000000000000100000000001000000000000000000000000000000000000011111000
00011111111111000111111111110001111000000000000000000000000000000000000011111000
00011111000000000000000000000000001000000000000000000000000000000000000011111000
00011111000000000000000000000000001000000000000000000000000000000000000011111000
00011111000000000000000000000000001000000000000000000000000000000000000011111000
00011111060011111100011111115551111000000000000000000000000000000000000011111000
00011111000010000000000100000000001000000000000000000000000000000000000011111000
00011111000010000000000100000000001000000000000000000000000000000000000011111000
00011111000010000000000100000000001000000000000000000000000000000000000011111000
00011111000010000000000100000000001000000000000000000000000000000000000011111000
00011111000010000000500100000000001000000000000000000000000000000000000011111000
00011111000010000010001000000000001000000000000000000000000000000000000011111000
00011111000010000000060000000006001000000000000000000000000000000000000011111000
00011111000010000000000000000000001000000000000000000000000000000000000011111000
00011111000010000000500100000000001000000000000000000000000000000000000011111000
00011111000011100011111111111100011000000000000000000000000000000000000011111000
00011111000000000000010550000000000444000000000000000000000000000000000011111000
00011111006000000000000000000000000444000000000000000000000000000000000011111000
00011111000000000000005001000000000444000000000000000000000000000000000011111000
00011111111111111111111111111111111100000000000000000000000000000000000011111000
00011111000000000000000000000000000000000000000000000000000000000000000011111000
00011111000000000000000000000000000000000000000000000000000000000000000011111000
00011111000000000000000000000000000000000000000000000000000000000000000011111000
00011111000000000000000000000000000000000000000000000000000000000000000011111000
00011111000000000000000000000000000000000000000000000000000000000000000011111000
00011111000000000000000000000000000000000000000000000000000000000000000011111000
00011111000000000000000000000000000000000000000000000000000000000000000011111000
00011111000000000000000000000000000000000000000000000000000000000000000011111000
00011111000000000000000000000000000000000000000000000000000000000000000011111000
00011111000000000000000000000000000000000000000000000000000000000000000011111000
00011111000000000000000000000000000000000000000000000000000000000000000011111000
00011111000000000000000000000000000000000000000000000000000000000000000011111000
00011111000000000000000000000000000000000000000000000000000000000000000011111000
00011111000000000000000000000000000000000000000000000000000000000000000011111000
00011111000000000000000000000000000000000000000000000000000000000000000011111000
00011111000000000000000000000000000000000000000000000000000000000000000011111000
00011111000000000000000000000000000000000000000000000000000000000000000011111000
00011111000000000000000000000000000000000000000000000000000000000000000011111000
00011111000000000000000000000000000000000000000000000000000000000000000011111000
00011111000000000000000000000000000000000000000000000000000000000000000011111000
00011111000000000000000000000000000000000000000000000000000000000000000011111000
00011111000000000000000000000000000000000000000000000000000000000000000011111000
00011111000000000000000000000000000000000000000000000000000000000000000011111000
00011111000000000000000000000000000000000000000000000000000000000000000011111000
00011111000000000000000000000000000000000000000000000000000000000000000011111000
00011111000000000000000000000000000000000000000000000000000000000000000011111000
00011111000000000000000000000000000000000000000000000000000000000000000011111000
00011111000000000000000000000000000000000000000000000000000000000000000011111000
00011111000000000000000000000000000000000000000000000000000000000000000011111000
00011111000000000000000000000000000000000000000000000000000000000000000011111000
00011111000000000000000000000000000000000000000000000000000000000000000011111000
00011111000000000000000000000000000000000000000000000000000000000000000011111000
00011111000000000000000000000000000000000000000000000000000000000000000011111000
00011111000000000000000000000000000000000000000000000000000000000000000011111000
00111111111111111111111111111111111111111111111111111111111111111111111111111100
00111111111111111111111111111111111111111111111111111111111111111111111111111100
00111111111111111111111111111111111111111111111111111111111111111111111111111100
00111111111111111111111111111111111111111111111111111111111111111111111111111100
00111111111111111111111111111111111111111111111111111111111111111111111111111100
00011111000000000000000000000000000000000000000000000000000000000000000000000000
00000000000000000000000000000000000000000000000000000000000000000000000000000000
00000000000000000000000000000000000000000000000000000000000000000000000000000000